20 21
0;0;0;0;0;0;0;0;0;0;0;0;0;0;0;0;0;0;0;0;
0;0;1;1;1;0;3;0;0;0;0;0;0;0;0;0;0;0;0;0;
0;0;0;0;0;0;3;0;0;0;0;0;1;1;0;4;4;4;0;0;
0;0;0;0;0;0;3;0;0;0;0;0;0;0;0;4;4;4;0;0;
0;0;0;0;0;0;3;0;0;0;0;0;0;0;0;4;4;4;0;0;
0;0;0;0;0;0;3;0;0;2;2;2;0;0;0;0;0;0;0;0;
0;0;0;0;0;0;3;0;0;0;0;0;0;1;1;0;0;0;0;0;
0;0;0;0;0;0;0;0;0;0;0;0;0;0;0;0;0;1;1;0;
0;0;0;0;0;0;0;0;0;0;0;0;0;0;0;0;0;0;0;0;
0;0;0;0;0;0;2;3;4;0;0;0;2;2;1;0;0;0;0;0;
0;0;0;0;0;0;2;3;4;0;0;0;3;3;3;0;0;0;0;0;
0;0;0;0;0;0;2;3;4;0;0;0;3;3;3;0;0;0;0;0;
0;0;0;0;0;0;2;0;4;0;0;0;0;2;2;0;0;0;0;0;
0;0;0;0;0;0;0;0;0;0;0;0;0;0;0;0;0;0;0;0;
0;0;0;0;0;0;0;0;0;0;0;0;0;0;0;0;0;0;0;0;
0;0;0;0;0;0;0;1;2;0;0;2;0;0;0;1;4;0;0;0;
0;0;0;1;1;0;0;1;2;0;0;0;0;0;0;1;3;0;0;0;
0;0;0;0;0;1;0;0;0;0;0;1;2;0;0;1;0;0;0;0;
0;1;0;0;0;0;0;0;0;0;0;1;0;0;0;1;0;0;0;0;
0;0;0;0;1;0;0;0;0;0;0;1;0;0;0;1;0;0;0;0;
0;0;0;0;1;0;0;0;0;0;0;1;0;0;0;1;0;0;0;0;



GRID
0,1,1
1,0,1
1,8,1
2,3,1
3,28,1
4,23,1
4,25,1
4,27,1
7,22,1
8,21,1
8,23,1
9,22,1
16,1,1
16,3,1
16,5,1
18,33,1
18,35,1
19,16,1
21,10,1
21,16,1
25,10,1
/GRID
