20 21
0;0;0;0;0;0;0;0;0;0;0;0;0;0;0;0;0;0;0;0;
0;0;1;1;1;0;3;0;0;0;0;0;0;0;0;0;0;0;0;0;
0;0;0;0;0;0;3;0;0;0;0;0;1;1;0;4;4;4;0;0;
0;0;0;0;0;0;3;0;0;0;0;0;0;0;0;4;4;4;0;0;
0;0;0;0;0;0;3;0;0;0;0;0;0;0;0;4;4;4;0;0;
0;0;0;0;0;0;3;0;0;2;0;2;0;0;0;0;0;0;0;0;
0;0;0;0;0;0;3;0;0;0;0;0;0;1;1;0;0;0;0;0;
0;0;0;0;0;0;0;0;0;0;0;0;0;0;0;0;0;1;1;0;
0;0;0;0;0;0;0;0;0;0;0;0;0;0;0;0;0;0;0;0;
0;0;0;0;0;0;2;3;4;0;0;0;0;0;1;0;0;0;0;0;
0;0;0;0;0;0;2;3;4;0;0;0;0;0;2;0;0;0;0;0;
0;0;0;0;0;0;2;3;4;0;0;0;2;1;2;0;0;0;0;0;
0;0;0;0;0;0;2;0;4;0;0;0;0;2;2;0;0;0;0;0;
0;0;0;0;0;0;0;0;0;0;0;0;0;0;0;0;0;0;0;0;
0;0;0;0;0;0;0;0;0;0;0;0;0;0;0;0;0;0;0;0;
0;1;0;0;0;0;0;0;0;0;0;0;0;0;1;0;0;0;0;0;
0;0;1;0;0;0;0;0;0;0;0;0;0;0;1;0;0;0;0;0;
0;0;0;1;0;0;0;0;0;0;0;0;0;1;0;0;0;0;0;0;
0;0;0;0;0;0;0;0;0;0;0;0;0;0;0;0;0;0;0;0;
0;0;0;1;0;0;0;0;0;0;0;0;0;0;0;0;0;0;0;0;
0;0;0;0;0;0;0;0;0;0;0;0;0;0;0;0;0;0;0;0;



GRID
3,28,Wall1
4,23,Wall1
4,25,OpenedDoor
4,27,Wall1
7,22,Wall1
8,21,Wall1
8,23,Wall1
9,22,Wall1
18,33,Wall1
18,35,Wall1
18,37,ClosedDoor
18,39,Wall1
19,16,ForceField
21,16,Wall1
/GRID



DEPLOY
/DEPLOY
