10 11
1;2;2;3;4;4;0;0;0;0;
1;3;2;2;3;3;0;0;1;1;
2;0;0;0;2;2;0;0;2;1;
2;0;0;0;0;0;0;0;3;2;
3;0;0;0;0;0;2;0;4;2;
3;0;0;0;0;0;2;3;4;3;
3;0;0;0;0;0;0;2;0;0;
2;0;0;0;0;0;0;0;0;0;
2;0;0;0;0;0;0;0;0;0;
2;0;0;0;0;0;0;0;0;0;
2;0;0;0;2;2;0;0;0;0;
