20 21
0;0;0;0;0;0;0;0;0;0;0;0;0;0;0;0;0;0;0;0;
0;0;1;1;1;0;3;0;0;0;0;0;0;0;0;0;0;0;0;0;
0;0;0;0;0;0;3;0;0;0;0;0;1;1;0;4;4;4;0;0;
0;0;0;0;0;0;3;0;0;0;0;0;0;0;0;4;4;4;0;0;
0;0;0;0;0;0;3;0;0;0;0;0;0;0;0;4;4;4;0;0;
0;0;0;0;0;0;3;0;0;2;2;2;0;0;0;0;0;0;0;0;
0;0;0;0;0;0;3;0;0;0;0;0;0;1;1;0;0;0;0;0;
0;0;0;0;0;0;0;0;0;0;0;0;0;0;0;0;0;1;1;0;
0;0;0;0;0;0;0;0;0;0;0;0;0;0;0;0;0;0;0;0;
0;0;0;0;0;0;2;3;4;0;0;0;2;2;1;0;0;0;0;0;
0;0;0;0;0;0;2;3;4;0;0;0;3;3;3;0;0;0;0;0;
0;0;0;0;0;0;2;3;4;0;0;0;3;3;3;0;0;0;0;0;
0;0;0;0;0;0;2;0;4;0;0;0;0;2;2;0;0;0;0;0;
0;0;0;0;0;0;0;0;0;0;0;0;0;0;0;0;0;0;0;0;
0;0;0;0;0;0;0;0;0;0;0;0;0;0;0;0;0;0;0;0;
0;0;0;0;0;0;0;1;2;0;0;2;0;0;0;1;4;0;0;0;
0;0;0;1;1;0;0;1;2;0;0;0;0;0;0;1;3;0;0;0;
0;0;0;0;0;1;0;0;0;0;0;1;2;0;0;1;0;0;0;0;
0;1;0;0;0;0;0;0;0;0;0;1;0;0;0;1;0;0;0;0;
0;0;0;0;1;0;0;0;0;0;0;1;0;0;0;1;0;0;0;0;
0;0;0;0;1;0;0;0;0;0;0;1;0;0;0;1;0;0;0;0;



GRID
4,25,Wall1
4,27,Wall1
4,29,Wall1
4,31,Wall1
4,33,Wall3
4,35,Wall3
/GRID
